  +--------+                                                    
  |........|                                                    
  |........|                       #######                      
  |........##########           ####              +------------+
  +----#---+        ######         #              |............|
       #                 #         #        ###   |............|
+------#---+             ###################      |............|
|..........|                 #         #          |............|
|..........#####          ####         ############............|
|..........|   ####       #                #      +------------+
+----#-----+              #                ########             
     #                                                          
     #               #####                                      
  +--#-----+     #####                                          
  |........|         #                                          
  |........###############################                      
  |........|                                                    
  +--------+                                                    
